10;13;;;;;;;;
#;#;#;#;#;#;#;#;#;#
#;#;Z; ;+;+;+;#;#;#
#;#; ;D_2; ; ;D_1; ;R;#
#;#; ;#;+;#;#; ;S_2_20;#
#;+; ; ;#;B;C_30; ;#;#
#;+; ;B;#; ;R;S_1;#;#
#;+; ; ;#;+;+;+;#;#
#;#;R;#;#;B;Z;B_2; ;#
#;#;R;#;#;#;B_20;B_4;B_3;#
#;#; ;#;S_3_10; ;#;#;B_4;#
#;#;Z; ; ; ; ;D_3; ;#
#;#;+;#;#;#;#;#;#;#
#;#;#;#;#;#;#;#;#;#