10;13;;;;;;;;
W;W;W;W;W;W;W;W;W;W
W;W;Z;E;+;+;+;W;W;W
W;W;E;D_2;E;E;D_1;E;R;W
W;W;E;W;+;W;W;E;S_2_20;W
W;+;E;E;W;B;C_30;E;W;W
W;+;E;B;W;E;R;S_1;W;W
W;+;E;E;W;+;+;+;W;W
W;W;R;W;W;B;Z;B_2;E;W
W;W;R;W;W;W;B_20;B_4;B_3;W
W;W;E;W;S_3_10;E;W;W;B_4;W
W;W;Z;E;E;E;E;D_3;E;W
W;W;+;W;W;W;W;W;W;W
W;W;W;W;W;W;W;W;W;W