10;13;;;;;;;;
W;W;W;W;W;W;W;W;W;W
W;W;Z;E;+;+;+;W;W;W
W;W;E;D_2;E;E;D_1;E;R;W
W;W;E;W;+;W;W;E;S_2;W
W;+;E;E;W;B;C;E;W;W
W;+;E;B;W;E;R;S_1;W;W
W;+;E;E;W;+;+;+;W;W
W;W;R;W;W;B;Z;B;E;W
W;W;R;W;W;W;B;B;B;W
W;W;E;W;S_3;E;W;W;B;W
W;W;Z;E;E;E;E;D_3;E;W
W;W;+;W;W;W;W;W;W;W
W;W;W;W;W;W;W;W;W;W